##########
#0.......#
#........#
#........#
#.......1#
##########